//MAP CONVERTED BY dmm2tgm.py THIS HEADER COMMENT PREVENTS RECONVERSION, DO NOT REMOVE
"a" = (
/obj/structure/window/reinforced{
	dir = 1
	},
/obj/structure/shuttle/engine/heater,
/obj/structure/window/reinforced{
	dir = 1
	},
/turf/open/floor/plating,
/area/space)
"b" = (
/obj/structure/chair/comfy/shuttle{
	dir = 1
	},
/turf/open/floor/iron/dark/dark_large,
/area/space)
"d" = (
/turf/open/space/openspace,
/area/space)
"e" = (
/obj/structure/sink{
	dir = 8;
	pixel_x = 11
	},
/turf/open/floor/deadspace/med/triage_corners{
	dir = 8
	},
/area/space)
"h" = (
/obj/machinery/light/directional/south,
/turf/open/floor/iron/dark,
/area/space)
"i" = (
/obj/machinery/light/directional/west,
/turf/open/floor/iron/dark,
/area/space)
"j" = (
/obj/structure/table/optable,
/obj/item/clothing/mask/breath/medical,
/turf/open/floor/deadspace/med/triage_sides{
	dir = 8
	},
/area/space)
"l" = (
/obj/machinery/computer/communications,
/turf/open/floor/iron/dark/dark_large,
/area/space)
"m" = (
/obj/machinery/button/door/directional/north{
	name = "external door control";
	req_access_txt = "150";
	id = "valor_shuttle"
	},
/turf/open/floor/iron/dark,
/area/space)
"o" = (
/turf/open/floor/iron/dark,
/area/space)
"p" = (
/obj/machinery/light/directional/west,
/turf/open/floor/deadspace/med/triage_sides,
/area/space)
"q" = (
/obj/structure/chair/comfy/shuttle{
	dir = 8
	},
/obj/effect/turf_decal/box/white,
/turf/open/floor/iron/dark/dark_large,
/area/space)
"s" = (
/obj/machinery/door/airlock/titanium,
/turf/open/floor/iron/dark,
/area/space)
"u" = (
/obj/machinery/door/airlock/shuttle{
	name = "cockpit"
	},
/turf/open/floor/iron/dark,
/area/space)
"v" = (
/obj/machinery/computer/crew/syndie{
	dir = 4
	},
/turf/open/floor/iron/dark,
/area/space)
"w" = (
/obj/machinery/computer/shuttle/ferry/request,
/turf/open/floor/iron/dark/dark_large,
/area/space)
"z" = (
/obj/structure/chair/comfy/shuttle,
/obj/effect/turf_decal/box/white,
/turf/open/floor/iron/dark/dark_large,
/area/space)
"A" = (
/obj/structure/table/reinforced/plastitaniumglass,
/obj/item/storage/fancy/donut_box,
/turf/open/floor/iron/dark/dark_large,
/area/space)
"C" = (
/turf/open/floor/deadspace/med/triage_sides{
	dir = 4
	},
/area/space)
"E" = (
/obj/machinery/door/airlock/shuttle,
/obj/machinery/door/poddoor/preopen{
	id_tag = "valor_shuttle";
	dir = 1
	},
/turf/open/floor/iron/dark,
/area/space)
"F" = (
/obj/machinery/defibrillator_mount/loaded/directional/east,
/turf/open/floor/deadspace/med/triage_sides{
	dir = 1
	},
/area/space)
"G" = (
/obj/structure/table/glass,
/obj/item/storage/medkit/tactical,
/obj/item/reagent_containers/spray/cleaner,
/obj/machinery/light/directional/south,
/turf/open/floor/deadspace/med/triage_sides{
	dir = 8
	},
/area/space)
"L" = (
/obj/machinery/button/door/directional/north{
	name = "external door control";
	req_access_txt = "150";
	id = "valor_shuttle"
	},
/obj/structure/table/reinforced/plastitaniumglass,
/turf/open/floor/iron/dark/dark_large,
/area/space)
"M" = (
/obj/structure/table/glass,
/obj/item/storage/medkit/surgery,
/turf/open/floor/deadspace/med/triage_corners,
/area/space)
"N" = (
/obj/structure/shuttle/engine/heater,
/obj/structure/window/reinforced{
	dir = 1
	},
/turf/open/floor/plating,
/area/space)
"P" = (
/turf/closed/wall/mineral/titanium,
/area/space)
"R" = (
/obj/machinery/vitals_monitor,
/turf/open/floor/deadspace/med/triage_corners{
	dir = 1
	},
/area/space)
"S" = (
/turf/open/floor/deadspace/med/triage_white,
/area/space)
"T" = (
/obj/machinery/computer/station_alert{
	dir = 8
	},
/turf/open/floor/iron/dark,
/area/space)
"U" = (
/obj/structure/tank_holder/anesthetic,
/turf/open/floor/deadspace/med/triage_corners{
	dir = 4
	},
/area/space)
"V" = (
/obj/structure/shuttle/engine/propulsion,
/turf/open/floor/plating,
/area/space)
"W" = (
/obj/structure/chair/comfy/shuttle{
	dir = 1
	},
/obj/effect/turf_decal/box/white,
/turf/open/floor/iron/dark/dark_large,
/area/space)
"X" = (
/obj/effect/spawner/structure/window/reinforced/shuttle,
/obj/machinery/door/poddoor/preopen{
	id_tag = "valor_shuttle"
	},
/turf/open/floor/plating,
/area/space)
"Y" = (
/obj/machinery/door/airlock/shuttle,
/obj/machinery/door/poddoor/preopen{
	id_tag = "valor_shuttle";
	dir = 1
	},
/obj/docking_port/mobile{
	dir = 8
	},
/turf/open/floor/iron/dark,
/area/space)
"Z" = (
/obj/machinery/iv_drip,
/obj/item/reagent_containers/blood/universal,
/turf/open/floor/deadspace/med/triage_sides{
	dir = 4
	},
/area/space)

(1,1,1) = {"
d
P
P
P
P
P
P
P
P
P
P
P
P
P
P
P
"}
(2,1,1) = {"
P
P
A
v
P
z
i
W
i
W
P
U
p
M
N
V
"}
(3,1,1) = {"
X
w
b
h
P
z
o
W
o
W
P
Z
S
G
N
V
"}
(4,1,1) = {"
X
l
b
o
u
o
o
o
o
o
s
C
S
j
a
V
"}
(5,1,1) = {"
P
P
L
T
P
m
o
o
o
q
P
e
F
R
N
V
"}
(6,1,1) = {"
d
P
P
P
P
P
P
Y
E
P
P
P
P
P
P
P
"}
